10123
1221212122
1222222122
1222211122
1221211122
1221222222
1221222222
1221112122
1221112122
1221112122
1221212122
